
、	,
。	.
「	“
」	”
『	“
』	”
ァ	a
ア	a
アー	â
ィ	i
イ	i
イー	î
ゥ	u
ウ	u
ウー	û
ェ	e
エ	e
エー	ê
ォ	o
オ	o
オー	ô
カ	ka
カー	kâ
ガ	ga
ガー	gâ
キ	ki
キェ	kye
キェー	kyê
キャ	kya
キャー	kyâ
キュ	kyu
キュー	kyû
キョ	kyo
キョー	kyô
キー	kî
ギ	gi
ギェ	gye
ギェー	gyê
ギャ	gya
ギャー	gyâ
ギュ	gyu
ギュー	gyû
ギョ	gyo
ギョー	gyô
ギー	gî
ク	ku
クィ	kwi
クィー	kwî
クェ	kwe
クェー	kwê
クョ	kwo
クョー	kwô
クヮ	kwa
クヮー	kwâ
クー	kû
グ	gu
グィ	gwi
グィー	gwî
グェ	gwe
グェー	gwê
グョ	gwo
グョー	gwô
グヮ	gwa
グヮー	gwâ
グー	gû
ケ	ke
ケー	kê
ゲ	ge
ゲー	gê
コ	ko
コー	kô
ゴ	go
ゴー	gô
サ	sa
サー	sâ
ザ	za
ザー	zâ
シ	si
シェ	sye
シェー	syê
シャ	sya
シャー	syâ
シュ	syu
シュー	syû
ショ	syo
ショー	syô
シー	sî
ジ	zi
ジェ	zye
ジェー	zyê
ジャ	zya
ジャー	zyâ
ジュ	zyu
ジュー	zyû
ジョ	zyo
ジョー	zyô
ジー	zî
ス	su
スー	sû
ズ	zu
ズー	zû
セ	se
セー	sê
ゼ	ze
ゼー	zê
ソ	so
ソー	sô
ゾ	zo
ゾー	zô
タ	ta
ター	tâ
ダ	da
ダー	dâ
チ	ti
チェ	tye
チェー	tyê
チャ	tya
チャー	tyâ
チュ	tyu
チュー	tyû
チョ	tyo
チョー	tyô
チー	tî
ヂ	di
ヂェ	dye
ヂェー	dyê
ヂャ	dya
ヂャー	dyâ
ヂュ	dyu
ヂュー	dyû
ヂョ	dyo
ヂョー	dyô
ヂー	dî
ッ	
ッカ	kka
ッカー	kkâ
ッガ	gga
ッガー	ggâ
ッキ	kki
ッキェ	kkye
ッキェー	kkyê
ッキャ	kkya
ッキャー	kkyâ
ッキュ	kkyu
ッキュー	kkyû
ッキョ	kkyo
ッキョー	kkyô
ッキー	kkî
ッギ	ggi
ッギェ	ggye
ッギェー	ggyê
ッギャ	ggya
ッギャー	ggyâ
ッギュ	ggyu
ッギュー	ggyû
ッギョ	ggyo
ッギョー	ggyô
ッギー	ggî
ック	kku
ックィ	kkwi
ックィー	kkwî
ックェ	kkwe
ックェー	kkwê
ックョ	kkwo
ックョー	kkwô
ックヮ	kkwa
ックヮー	kkwâ
ックー	kkû
ッグ	ggu
ッグィ	ggwi
ッグィー	ggwî
ッグェ	ggwe
ッグェー	ggwê
ッグョ	ggwo
ッグョー	ggwô
ッグヮ	ggwa
ッグヮー	ggwâ
ッグー	ggû
ッケ	kke
ッケー	kkê
ッゲ	gge
ッゲー	ggê
ッコ	kko
ッコー	kkô
ッゴ	ggo
ッゴー	ggô
ッサ	ssa
ッサー	ssâ
ッザ	zza
ッザー	zzâ
ッシ	ssi
ッシェ	ssye
ッシェー	ssyê
ッシャ	ssya
ッシャー	ssyâ
ッシュ	ssyu
ッシュー	ssyû
ッショ	ssyo
ッショー	ssyô
ッシー	ssî
ッジ	zzi
ッジェ	zzye
ッジェー	zzyê
ッジャ	zzya
ッジャー	zzyâ
ッジュ	zzyu
ッジュー	zzyû
ッジョ	zzyo
ッジョー	zzyô
ッジー	zzî
ッス	ssu
ッスー	ssû
ッズ	zzu
ッズー	zzû
ッセ	sse
ッセー	ssê
ッゼ	zze
ッゼー	zzê
ッソ	sso
ッソー	ssô
ッゾ	zzo
ッゾー	zzô
ッタ	tta
ッター	ttâ
ッダ	dda
ッダー	ddâ
ッチ	tti
ッチェ	ttye
ッチェー	ttyê
ッチャ	ttya
ッチャー	ttyâ
ッチュ	ttyu
ッチュー	ttyû
ッチョ	ttyo
ッチョー	ttyô
ッチー	ttî
ッヂ	ddi
ッヂェ	ddye
ッヂェー	ddyê
ッヂャ	ddya
ッヂャー	ddyâ
ッヂュ	ddyu
ッヂュー	ddyû
ッヂョ	ddyo
ッヂョー	ddyô
ッヂー	ddî
ッツ	ttu
ッツー	ttû
ッヅ	ddu
ッヅー	ddû
ッテ	tte
ッテー	ttê
ッデ	dde
ッデー	ddê
ット	tto
ットー	ttô
ッド	ddo
ッドー	ddô
ッナ	nna
ッナー	nnâ
ッニ	nni
ッニェ	nnye
ッニェー	nnyê
ッニャ	nnya
ッニャー	nnyâ
ッニュ	nnyu
ッニュー	nnyû
ッニョ	nnyo
ッニョー	nnyô
ッニー	nnî
ッヌ	nnu
ッヌー	nnû
ッネ	nne
ッネー	nnê
ッノ	nno
ッノー	nnô
ッハ	hha
ッハー	hhâ
ッバ	bba
ッバー	bbâ
ッパ	ppa
ッパー	ppâ
ッヒ	hhi
ッヒェ	hhye
ッヒェー	hhyê
ッヒャ	hhya
ッヒャー	hhyâ
ッヒュ	hhyu
ッヒュー	hhyû
ッヒョ	hhyo
ッヒョー	hhyô
ッヒー	hhî
ッビ	bbi
ッビェ	bbye
ッビェー	bbyê
ッビャ	bbya
ッビャー	bbyâ
ッビュ	bbyu
ッビュー	bbyû
ッビョ	bbyo
ッビョー	bbyô
ッビー	bbî
ッピ	ppi
ッピェ	ppye
ッピェー	ppyê
ッピャ	ppya
ッピャー	ppyâ
ッピュ	ppyu
ッピュー	ppyû
ッピョ	ppyo
ッピョー	ppyô
ッピー	ppî
ッフ	hhu
ッフー	hhû
ッブ	bbu
ッブー	bbû
ップ	ppu
ップー	ppû
ッヘ	hhe
ッヘー	hhê
ッベ	bbe
ッベー	bbê
ッペ	ppe
ッペー	ppê
ッホ	hho
ッホー	hhô
ッボ	bbo
ッボー	bbô
ッポ	ppo
ッポー	ppô
ッマ	mma
ッマー	mmâ
ッミ	mmi
ッミェ	mmye
ッミェー	mmyê
ッミャ	mmya
ッミャー	mmyâ
ッミュ	mmyu
ッミュー	mmyû
ッミョ	mmyo
ッミョー	mmyô
ッミー	mmî
ッム	mmu
ッムー	mmû
ッメ	mme
ッメー	mmê
ッモ	mmo
ッモー	mmô
ッヤ	yya
ッヤー	yyâ
ッユ	yyu
ッユー	yyû
ッヨ	yyo
ッヨー	yyô
ッラ	rra
ッラー	rrâ
ッリ	rri
ッリェ	rrye
ッリェー	rryê
ッリャ	rrya
ッリャー	rryâ
ッリュ	rryu
ッリュー	rryû
ッリョ	rryo
ッリョー	rryô
ッリー	rrî
ッル	rru
ッルー	rrû
ッレ	rre
ッレー	rrê
ッロ	rro
ッロー	rrô
ッワ	wwa
ッワー	wwâ
ッヰ	wwi
ッヰー	wwî
ッヱ	wwe
ッヱー	wwê
ッヲ	wwo
ッヲー	wwô
ツ	tu
ツー	tû
ヅ	du
ヅー	dû
テ	te
テー	tê
デ	de
デー	dê
ト	to
トー	tô
ド	do
ドー	dô
ナ	na
ナー	nâ
ニ	ni
ニェ	nye
ニェー	nyê
ニャ	nya
ニャー	nyâ
ニュ	nyu
ニュー	nyû
ニョ	nyo
ニョー	nyô
ニー	nî
ヌ	nu
ヌー	nû
ネ	ne
ネー	nê
ノ	no
ノー	nô
ハ	ha
ハー	hâ
バ	ba
バー	bâ
パ	pa
パー	pâ
ヒ	hi
ヒェ	hye
ヒェー	hyê
ヒャ	hya
ヒャー	hyâ
ヒュ	hyu
ヒュー	hyû
ヒョ	hyo
ヒョー	hyô
ヒー	hî
ビ	bi
ビェ	bye
ビェー	byê
ビャ	bya
ビャー	byâ
ビュ	byu
ビュー	byû
ビョ	byo
ビョー	byô
ビー	bî
ピ	pi
ピェ	pye
ピェー	pyê
ピャ	pya
ピャー	pyâ
ピュ	pyu
ピュー	pyû
ピョ	pyo
ピョー	pyô
ピー	pî
フ	hu
フー	hû
ブ	bu
ブー	bû
プ	pu
プー	pû
ヘ	he
ヘー	hê
ベ	be
ベー	bê
ペ	pe
ペー	pê
ホ	ho
ホー	hô
ボ	bo
ボー	bô
ポ	po
ポー	pô
マ	ma
マー	mâ
ミ	mi
ミェ	mye
ミェー	myê
ミャ	mya
ミャー	myâ
ミュ	myu
ミュー	myû
ミョ	myo
ミョー	myô
ミー	mî
ム	mu
ムー	mû
メ	me
メー	mê
モ	mo
モー	mô
ャ	
ヤ	ya
ヤー	yâ
ュ	
ユ	yu
ユー	yû
ョ	
ヨ	yo
ヨー	yô
ラ	ra
ラー	râ
リ	ri
リェ	rye
リェー	ryê
リャ	rya
リャー	ryâ
リュ	ryu
リュー	ryû
リョ	ryo
リョー	ryô
リー	rî
ル	ru
ルー	rû
レ	re
レー	rê
ロ	ro
ロー	rô
ワ	wa
ワー	wâ
ヰ	wi
ヰー	wî
ヱ	we
ヱー	wê
ヲ	wo
ヲー	wô
ン	n
・	-
ー	
ヿ	koto
