new = "New"
open = "Open"
save = "Save"
close = "Close"
quit = "Quit"
edit = "Edit"
search = "Search"
undo = "Undo"
redo = "Redo"
cut = "Cut"
copy = "Copy"
paste = "Paste"
delete = "Delete"
path = "Path"
file = "File"
folder = "Folder"
name = "Name"
size = "Size"
type = "Type"
created = "Created"
modified = "Modified"
login = "Login"
logout = "Logout"
config = "Configuration"
language = "Language"
help = "Help"
version = "Version"
prev = "Previous"
next = "Next"
refresh = "Refresh"
stop = "Stop"
ok = "OK"
cancel = "Cancel"
yes = "Yes"
no = "No"
