locale = "bg"
new = "Нов"
open = "Отваряне"
close = "Затваряне"
quit = "Изход"
edit = "Редактиране"
search = "Търсене"
undo = "Отмяна"
redo = "Възвръщане"
cut = "Отрязване"
copy = "Копиране"
paste = "Вмъкване"
delete = "Изтриване"
path = "Път"
file = "Файл"
folder = "Директория"
name = "Име"
size = "Размер"
type = "Тип"
created = "Създаден"
modified = "Изменен"
language = "Език"
help = "Помощ"
version = "Версия"
prev = "Предишна"
next = "Следваща"
refresh = "Презареди"
stop = "Спри"
cancel = "Отказ"
yes = "Да"
no = "Не"
