locale=da
new=Ny
open=Åbn
save=Gem
close=Luk
quit=Afslut
edit=Rediger
search=Søg
undo=Fortryd
redo=Gendan
cut=Klip
copy=Kopier
paste=Sæt ind
delete=Slet
path=Sti
file=Fil
folder=Mappe
name=Navn
size=Størrelse
type=Type
created=Oprettet
modified=Ændret
config=Indstillinger
language=Sprog
help=Hjælp
version=Version
prev=Forrige
next=Next
refresh=Opdater
stop=Stop
cancel=Annuller
yes=Ja
no=Nej
