locale=de
new=Neue
open=Öffnen
save=Sparen
close=Schließen
quit=Beenden
edit=Bearbeiten
search=Suche
undo=Rückgängig
redo=Wiederherstellen
cut=Ausschneiden
copy=Kopieren
paste=Einfügen
delete=Löschen
path=Pfad
file=Datei
folder=Ordner
name=Name
size=Größe
type=Typ
created=Erstellt am
modified=Geändert am
config=Konfiguration
language=Sprache
help=Hilfe
version=Version
prev=Vorherige
next=Nächste
refresh=Neu laden
stop=Abbrechen
cancel=Abbrechen
yes=Ja
no=Nein
