locale=el
new=Νέο
open=Άνοιγμα
save=αποθηκεύσετε
close=Κλείσιμο
quit=Έξοδος
edit=Επεξεργασία
search=Αναζήτηση
undo=Αναίρεση
redo=Επανάληψη
cut=Αποκοπή
copy=Αντιγραφή
paste=Επικόλληση
delete=Διαγραφή
path=Θέση
file=Αρχείο
folder=Φάκελος
name=Όνομα
size=Μέγεθος
created=Δημιουργήθηκε
modified=Τροποποιήθηκε
login=σύνδεση
logout=Αποσύνδεση
config=Διαμόρφωση
language=Γλώσσες
help=Βοήθεια
version=Έκδοση
prev=Προηγούμενο
next=Επόμενο
refresh=Ανανέωση
stop=Διακοπή
cancel=Άκυρο
yes=Ναι
no=Όχι
