locale = "es"
new = "Nuevo"
open = "Abrir"
save = "Ahorrar"
close = "Close"
quit = "Salir"
edit = "Editar"
search = "Búsqueda"
undo = "Deshacer"
redo = "Rehacer"
cut = "Cortar"
copy = "Copiar"
paste = "Pegar"
delete = "Borrar"
path = "Ruta"
file = "Archivo"
folder = "Directorio"
name = "Nombre"
size = "Tamaño"
created = "Creado"
modified = "Modificado"
config = "Configuración"
language = "Idioma"
help = "Ayuda"
version = "Versión"
prev = "Anterior"
next = "Siguiente"
refresh = "Refrescar"
stop = "Detener"
ok = "Aceptar"
cancel = "Cancelar"
yes = "Sí"
no = "No"
