locale=fi
new=Uusi
open=Avaa
save=Tallenna
close=Sulje
quit=Lopeta
edit=Muokkaa
search=Etsi
undo=Kumoa
redo=Toista
cut=Leikkaa
copy=Kopioi
paste=Liitä
delete=Poista
path=Polku
file=Tiedosto
folder=Kansio
name=Nimi
size=Koko
type=Tyyppi
created=Luotu
modified=Muokattu
config=Asetukset
language=Kieli
help=Ohje
version=Versio
prev=Edellinen
next=Seuraava
refresh=Päivitä
stop=Pysäytä
cancel=Peruuta
yes=Kyllä
no=Ei
