locale = "fr"
new = "Nouveau"
open = "Ouvrir"
save = "Sauver"
close = "Fermer"
quit = "Quitter"
edit = "Edition"
search = "Rechercher"
undo = "Annuler"
redo = "Refaire"
cut = "Couper"
copy = "Copier"
paste = "Coller"
delete = "Supprimer"
path = "Chemin"
file = "Fichier"
folder = "Dossier"
name = "Nom"
type = "Type"
size = "Taille"
created = "Créé le"
modified = "Modifié le"
login = "Connectez-vous"
logout = "Déconnexion"
config = "Configuration"
language = "Langues"
help = "Aide"
version = "Version"
prev = "Précédent"
next = "Suivant"
refresh = "Rafraichir"
stop = "Arrêter"
cancel = "Annuler"
yes = "Oui"
no = "Non"
