locale=hi
new=नया
open=खोले
save=बचाना
close=बंद करो
quit=निर्गमन
edit=संपादन
search=खोज
undo=पुर्वस्थिती(पहले जैसा)
redo=पुनः करें
cut=काटे
copy=नकल करें
paste=चिपकायें
delete=मिटायें
path=मार्ग
file=फ़ाइल
folder=फोल्डर
name=नाम
size=आकार
type=प्रकार
created=सर्जित
modified=परिवर्धित
config=व्यवस्थाएँ
language=भाषा
help=मदद
version=संस्करण
ok=ठीक है
cancel=रद्द
yes=हाँ
no=नहीं
