locale=hu
new=Új
open=Megnyitás
save=Menteni
close=Bezárás
quit=Kilépés
edit=Szerkesztés
search=Keresés
undo=Visszavonás
redo=Ismét
cut=Kivágás
copy=Másolás
paste=Beillesztés
delete=Törlés
path=Útvonal
file=Fájl
folder=Mappa
name=Név
size=Méret
type=Típus
created=Létrehozva
modified=Módosítva
config=Beállítása
language=Nyelv
help=Súgó
version=Verzió
prev=Vissza
next=Előre
refresh=Frissítés
stop=Megállítás
cancel=Mégsem
yes=Igen
no=Nem
