locale = "it"
new = "Nuovo"
open = "Apri"
save = "Salvo"
close = "Chiudi"
quit = "Esci"
edit = "Modifica"
search = "Ricerca"
undo = "Annulla"
redo = "Ripeti"
cut = "Taglia"
copy = "Copia"
paste = "Incolla"
delete = "Elimina"
path = "Percorso"
file = "File"
folder = "Cartella"
name = "Nome"
size = "Dimensione"
type = "Tipo"
created = "Creato"
modified = "Ultima modifica"
config = "Configurazione"
language = "Lingue"
help = "Aiuto"
version = "Versione"
prev = "Precedente"
next = "Successiva"
refresh = "Aggiorna"
stop = "Ferma"
cancel = "Annulla"
yes = "SÃ¬"
no = "No"
