locale=ja
new=新規
open=開く
save=保存
close=閉じる
quit=終了
edit=編集
search=検索
undo=元に戻す
redo=やり直し
cut=切り取り
copy=コピー
paste=貼り付け
delete=削除
path=パス
file=ファイル
folder=フォルダ
name=名前
size=サイズ
type=種類
created=作成日時
modified=変更日時
login=ログイン
logout=ログアウト
config=設定
language=言語
help=ヘルプ
version=バージョン
prev=戻る
next=進む
refresh=更新
stop=中止
cancel=キャンセル
yes=はい
no=いいえ
