locale = "ko"
new = "새"
open = "열기"
close = "닫기"
quit = "끝내기"
edit = "편집"
search = "찾기"
undo = "실행 취소"
redo = "다시 실행"
cut = "잘라내기"
copy = "복사"
paste = "붙여넣기"
delete = "삭제"
path = "경로"
file = "파일"
folder = "폴더"
name = "이름"
size = "크기"
type = "형식"
created = "만든 날짜"
modified = "솔리드"
config = "설정"
language = "언어"
help = "도움말"
version = "버전"
prev = "뒤로"
next = "앞으로"
refresh = "새로고침"
stop = "중지"
ok = "확인"
cancel = "취소"
yes = "예"
no = "아니오"
