locale = "pl"
new = "Nowy"
open = "Otwórz"
save = "Zapisać"
close = "Zamknij"
quit = "Zakończ"
edit = "Edycja"
search = "Szukaj"
undo = "Cofnij"
redo = "Powtórz"
cut = "Wytnij"
copy = "Kopiuj"
paste = "Wkl&ej"
delete = "Usuń"
path = "Ścieżka"
file = "Plik"
folder = "Folder"
name = "Nazwa"
size = "Rozmiar"
type = "Typ"
created = "Utworzony"
modified = "Zmodyfikowany"
config = "Konfiguracja"
language = "Językach"
help = "Pomoc"
version = "Wersja"
prev = "Wstecz"
next = "Dalej"
refresh = "Odśwież"
stop = "Stop"
cancel = "Anuluj"
yes = "Tak"
no = "Nie"
