locale = "pt"
new = "Novo"
open = "Abrir"
save = "Salvar"
close = "Fechar"
quit = "Sair"
edit = "Editar"
search = "Pesquisa"
undo = "Desfazer"
redo = "Refazer"
cut = "Cortar"
copy = "Copiar"
paste = "Colar"
delete = "Apagar"
path = "Destino"
file = "Ficheiro"
folder = "Pasta"
name = "Nome"
size = "Tamanho"
type = "Tipo"
created = "Criado"
modified = "Modificado"
config = "Definições"
language = "Idioma"
help = "Ajuda"
version = "Versão"
prev = "Voltar"
next = "Avançar"
refresh = "Atualizar"
stop = "Parar"
cancel = "Cancelar"
yes = "Sim"
no = "Não"
