locale=ru
new=Новый
open=Открыть
save=Экономить
close=Закрыть
quit=Выход
edit=Редактировать
search=Поиск
undo=Отменить
redo=Вернуть
cut=Вырезать
copy=Копировать
paste=Вставить
delete=Удалить
path=Путь
file=Файл
folder=Папка
name=Имя
size=Размер
type=Тип
created=Создан
modified=Изменен
config=Конфигурация
language=Языках
help=Помощь
version=Версия
prev=Назад
next=Вперёд
refresh=Обновить
stop=Стоп
cancel=Отмена
yes=Да
no=Нет
