locale=sv
new=Ny
open=Öppna
save=Spara
close=Stäng
quit=Avsluta
edit=Redigera
search=Sök
undo=Ångra
redo=Gör om
cut=Klipp ut
copy=Kopiera
paste=Klistra in
delete=Ta bort
path=Sökväg
file=Arkiv
folder=Mapp
name=Namn
size=Storlek
type=Typ
created=Skapad
modified=Ändrad
config=Konfiguration
language=Språk
help=Hjälp
version=Version
prev=Föregående
next=Nästa
refresh=Uppdatera
stop=Stopp
cancel=Avbryt
yes=Ja
no=Nej
