locale=th
new=ใหม่
open=เปิด
save=ประหยัด
close=ออก
quit=ออก
edit=แก้ไข
search=ค้นหา
undo=ทำกลับ
redo=ทำซ้ำ
cut=ตัด
copy=คัดลอก
paste=วาง
delete=ลบ
path=ที่ตั้ง
file=แฟ้ม
folder=โฟลเดอร์
name=ชื่อ
size=ขนาด
type=แบบชนิด
created=สร้างเมื่อ
modified=ดัดแปรเมื่อ
config=การกำหนดค่า
language=ภาษาอื่น
help=ช่วยเหลือ
version=เวอร์ชั่น
prev=หน้าที่แล้ว
next=หน้าถัดไป
refresh=รีเฟรช
stop=หยุด
ok=ตกลง
cancel=ยกเลิก
yes=ใช่
no=ไม่
