locale=tr
new=Yeni
open=Aç
save=Kurtarmak
close=Kapat
quit=Çık
edit=Düzenle
search=Ara
undo=Geri al
redo=Yinele
cut=Kes
copy=Kopyala
paste=Yapıştır
delete=Sil
path=Yol
file=Dosya
folder=Klasör
name=Ad
size=Boyut
type=Tür
created=Oluşturma
modified=Değiştirme
config=Yapılandırma
language=Diller
help=Yardım
version=Sürüm
prev=Geri
next=İleri
refresh=Yenile
stop=Durdur
ok=Tamam
cancel=İptal
yes=Evet
no=Hayır
