locale = "vi"
new = "Mới"
open = "Mở"
save = "Tiết kiệm"
close = "Đóng"
quit = "Thoát"
edit = "Biên tập"
search = "Tìm kiếm"
undo = "Như cũ"
redo = "Làm lại"
cut = "Cắt"
copy = "Sao chép"
paste = "Dán"
delete = "Xoá"
path = "Đường dẫn"
file = "Tập tin"
folder = "Thư mục"
name = "Tên"
size = "kích thước"
type = "Loại"
created = "Thời điểm tạo thành"
modified = "Thời điểm sửa đổi"
config = "Cấu hình"
language = "Ngôn ngữ"
help = "Giúp đỡ"
prev = "Trở về"
next = "Kế tiếp"
refresh = "Làm mới"
stop = "Dừng lại"
ok = "Đồng ý"
cancel = "Huỷ bỏ"
yes = "Có"
no = "Không"
