locale=zh
new=新建
open=打开
save=保存
close=关闭
quit=退出
edit=编辑
search=搜索
undo=撤消
redo=重做
cut=剪切
copy=复制
paste=粘贴
delete=删除
path=路径
file=文件
folder=文件夹
name=名称
size=大小
type=类型
created=创建日期
modified=修改日期
login=登录
logout=登出
config=设置
language=语言
help=帮助
version=版本
prev=返回
next=前进
refresh=刷新
stop=停止
ok=确定
cancel=取消
yes=是
no=否
