Α	A
Β	B
Γ	G
Δ	D
Ε	E
Ζ	Z
Η	Ē
Θ	TH
Ι	I
Κ	K
Λ	L
Μ	M
Ν	N
Ξ	X
Ο	O
Π	P
Ρ	R
Σ	S
Τ	T
Υ	U
Φ	PH
Χ	KH
Ψ	PS
Ω	Ō
α	a
β	b
γ	g
δ	d
ε	e
ζ	z
η	ē
θ	th
ι	i
κ	k
λ	l
μ	m
ν	n
ξ	x
ο	o
π	p
ρ	r
ς	s
σ	s
τ	t
υ	u
φ	ph
χ	kh
ψ	ps
ω	ō
